WWWWWWWWWWWW
WFDFFFFFFFFW
WFFFFFFFCFFW
WFFFFFCWWWWW
WFFFFFFWFFFW
WFFFFFFWFFFW
WFFFFFFWFFFW
WFFDFFFFPFFW
WFFFFFFFFFFW
WFFCFFFFDFFW
WFFFFFFFFFFW
WWWWWWWWWWWW







