WWWWWWWWWWWW
WFDFFFFFFFFW
WFFFFFFFCFFW
WFFFFFCWWWWW
WFFFFFFWPFFW
WFFFFFFWFFFW
WFFFFFFWFFFW
WFFDFFFFFFFW
WFFFFFFFFFFW
WFFCFFFFDFFW
WFFFFFFFFFFW
WWWWWWWWWWWW







