WWWWWWWWWWWW
WFDFFFFFFFFW
WFFFFFFFCFFW
WFFFFFCFFFFW
WFFFFFFFPFFW
WFFFFFFFFFFW
WFFFFFFFFFFW
WFFDFFFFFFFW
WFFFFFFFFFFW
WFFCFFFFWWWW
WFDWFFFFFFFW
WWWWWWWWWWWW


