WWWWWWWWWWWW
WFDWFFFFFFFW
WFFWFFFFCFFW
WFFFFCFWWFFW
WFFWWWWWFFFW
WFFFFFFWFFFW
WWWWWFFWFFFW
WFFDWFFWPFFW
WFFFWFFFFFFW
WFFCWFFFDFFW
WFFFFFFFFFFW
WWWWWWWWWWWW







