WWWWWWWWWWWW
WFDFFFFFFFFW
WFFFFFFFCFFW
WFFWWWCWWFFW
WFFFFFFPWFFW
WFFFFFFFWFFW
WFFFFFFFWFFW
WFFDFFFFWCFW
WFFFFFFFFFFW
WFFCFFWWWWWW
WFDWFFFFFFDW
WWWWWWWWWWWW


