WWWWWWWWWWWW
WFDFFFFFFFFW
WFFFFFFFCFFW
WFFWWWCWWFFW
WFFFFFFFWFFW
WFFFFFFFWFFW
WFFFFFFFWFFW
WFFDFFFFWCFW
WFFFFFFFFFFW
WFFCFFWWWWWW
WFDWFFFFFPDW
WWWWWWWWWWWW
