WWWWWWWWWWWW
WFDFFFFFFFFW
WFFFFFFFCFFW
WFFWWWCWWFFW
WFFCFFFFWFFW
WFFFFDFFWFFW
WCFFFFFFWFFW
WFFDFFFDWCFW
WFFFFFFFFFFW
WFFCFFWWWWWW
WFDWFFFFFPDW
WWWWWWWWWWWW



